A binder,A class folder binding loose paper
A report,Un compte rendu
All Saints Vacation,la toussain
A placement test,un test de niveau
To be unveiled,To be revealed/inaugurated
To topple a monument,To destroy/break a monument
The flip of the coin,the second side/the bad aspect
Wisdom teeth,Dent de sagesse
A key question,Une problématique
Consumer society,La société de consommation
A minstrel,Un ministrel
A tomboy,Un garçon manqué
Whom,The person whom I wanted to see was absent
Who,The person who was in the restaurant was nice
A competitive exam,Un examen
Ephemeral art,Temporary
To bounce,Rebondir
To adhere,To agree
Strength,Force
College,1st 4 years of University
Collège,Junior high (school)
Lycée,Senior high (School)
PhD,Doctora

Patrons = Customer
To parton a place = to be a frequent customer of a place
To stagger = tituber

OULIPO = Ouvroire de la literature international
Bold/courageous = brave/courageux
Bald = no hair on your head
A wake-up call = a warning cry
To be in shambles / ruins = être en ruine
A Coroner = a forensic doctor (legal doctor)
To be deceiving = être décevant
A candlelight vigil = tribut with candles (generaly silent gathering)/un homage avec des bougies
A saying = a proverb
Drowsy = sleepy
Defacement = Vandalism
Shameless = sans honte
Skull = crâne
To be overdue = too late
A screen play = le scénario
A trigger = l’élément déclancheur
To shred = déchiqueter
To cruch = broyer
A tab
Driver’s licence = permis de conduir
A civil servant = un fonctionnaire d'état
A masterpiece = un chef d'oeuvre
A tangle = a knot
A thorn
An innuendo = un sous-entendut
Unrest = agitation
Theocracies = countries governed by religion
Commencement = graduation day
Stendal Syndrom = to experience an intense effect
To wail = se lamenter
Keen = sharp (senses)
An Internship = a training
A solicitor = un notaire
Tilted = penché/incliné
Once bitten twice shy = chat échaudé craint l’eau froide
Utmost = extreme/maximum
A cleavage = un décolté
A pun = a word play
A footage = a clip
An anthem = a hymn
Une Colombe = a dove
To be dressed up to the nines = être sur son 31
To be on cloud 9 = être sur un petit nuage
Shaby = louche, odd, sleezy, fishy
Hispanics = Spanish speaking (can come from spain, Mexico, Chile, Argentina, …)
Latinos = Born in Latin America (Brazil, Venezuela, Mexico, Chile, Argentina, …)

$ = symbol of Capitalism
A pen name = a name you take as an artist
A voice Over = une voie off
Average = la moyenne

A voice Over = une voie off
Average = la moyenne
Labo(u)r = la main d’œuvre
A cleavage = un décolté
A pun = a word play
A footage = a clip
An anthem = a hymn
A saw = une scie
A motto = une devise
A cork = un bouchon de liège
To peep = regarder sans être vu
A PeepingTom = un voyeur (a person who looks without being seen)
A chopper = a helicopter
A portmanteau word = un mot valise
Ustopia --> dystopia
	        Utopia
Attorney General = un minister de la justice
It is excruciating = it is umberable
To lose one’s temper = perdre sa patience
Politics = politique
The driving licence/drivers licence = un permis de conduire
A masterpiece = chef d’oeuvre
To disappoint = ne pas être à la hauteur
A conductor = un chef d’orchestre
A hawk = un aigle
A dove = une colombe
A well
To file a complaint
