Stil = le style
Damals = avant
Noch = jusqu'à présent
Aufbrechen = partir en voyage
Auswanderung = émigration
Freiwillig = volontairement
Bayern = la Bavoire
Leiden = souffrir
Ärmsten = le plus pauvres
Armen = Les pauvres
Der Weg = le chemin
Wandern = airer
Staatsbürger = le citoyen
Sichern = sûre
Kunde = le client
Ob = si
Zelt = tante
Beine = les jambes
Anstrengend = fatigant
Zerschleißen = user de
Erkennen = reconnaitre/voir/se rendre compte
Schneider = un tailleur
Beinkleidern = leg clothes
Verbreiten = s'étendre
Bald = bientôt
Stoff = tissu
Erfolgreich = avoir du succès
Unternehmer = entrepreneur
Erben = l'héritage/hériter
Straßenhändler = un vendeur de rue.
Die Herkunft = l'origine
Schildern = décrire
Des Erfolgs = le succès
Ausgemachen = le succès
Stück für Stück = petit à petit
Einen Laden = une boutique
Aus Stoff von Zelt = du tissus de tante*Statt/finden = avoir lieu
Die Wiedervereinigung = la fête nationnale
Die Haltung = das Verhalten = le comportement
Bezeichnen = qualifier
Der Staat (en) = l'état
Behandeln = traiter.
Neben  = à côté de
Sich interessieren für +A = s'interesser à
Aus/brechen = éclater
Die öffentliche Verbrennung = autodaffe
Die Voraussetzung = la condition
Der Büger (-) = le citoyen
Der Einwohner (-) = l'habitant
Die Stiftung = la fondation
Forschen = faire de la recherche
Leicht = facile/léger
Schwer = difficile/lourd
Das Netzwerk (e) = le réseau
Ein Netzwerk pflegen = entretenir un réseau.
Das Fach (¨er) = 
Das Fachgebiet = la spécialité
Der Nobepreis = le prix nobel
Der Nobelpreisträger = porteur de prix nobel.
Der Mut = courrage
Muttig = courrageux
Er mutigen = encourager
Förden = encourager
Der Held = le héro
Der Helm = la casque
Zur Verfügung stellen = mettre à disposition
Offen = ouvert
Die Offenheit = l'ouverture d'esprit
Die Finanzielle Unterstützen.
Eine Sprache verbessern = améliorer
Eine Sprache Vertiefen = un langue approfondie
Freunde gewinnen = se faire des amis
An/bieten = proposer
Bieten = offrir
Der Lebenlauf = le CV
